__________
|.....@..|
|....|__.|
|......|.|
__________